11
10
75
1
1
9
8
MMMMMMMMMMM
MAAAAAAAAAM
MAAAAMAAAAM
MAAAMMMAAAM
MAAAMAMAAAM
MAAMMAMMAAM
MAAMMMMMAAM
MAMMAAAMMAM
MAMAAAAAMAM
MMMMMMMMMMM