9
7
75
0
0
8
6
AAAAMAAAA
AAAMMMAAA
AAAMAMAAA
AAMMAMMAA
AAMMMMMAA
AMMAAAMMA
AMAAAAAMA
